1111111111111
10010000P00C1
10C0011111001
1P0011E00C001
1111111111111
