111111111111111111111111111
100100000000000000000000001
100100000000000000000000001
100100000000000000000000001
100100000000000000000000001
100100000000000000000000001
10010000000C000000000000001
10C001111100000000001000001
1P0011E00C00000000000000001
111111111111111111111111111
